{
  "description": "Predefined 13x13 level layout for tank battle. 0=empty, 1=brick, 2=steel, 3=water, 4=forest, 5=base",
  "level1": [
    [0,0,0,0,0,0,0,0,0,0,0,0,0],
    [0,1,0,0,1,1,0,1,1,0,0,1,0],
    [2,0,2,0,2,0,0,0,2,0,2,0,2],
    [0,0,1,0,0,0,0,0,0,0,1,0,0],
    [4,4,0,1,0,0,1,0,0,1,0,4,4],
    [1,1,0,3,3,1,0,1,3,3,0,1,1],
    [4,0,1,4,0,3,0,3,0,4,1,0,4],
    [2,1,1,1,1,0,0,0,1,1,1,1,2],
    [1,0,2,0,1,0,4,0,1,0,2,0,1],
    [0,1,0,4,4,1,0,1,4,4,0,1,0],
    [0,0,1,0,3,0,1,0,3,0,1,0,0],
    [0,0,0,0,0,1,1,1,0,0,0,0,0],
    [0,0,1,1,0,1,5,1,0,1,1,0,0]
  ]
}
